16
14
22 0 0 0 0 0 0 0 0 0 0 0 0 0 0 22
22 0 0 0 0 0 0 0 0 0 0 0 0 0 0 22
22 0 24 24 24 24 24 24 24 24 0 0 0 0 0 22
22 0 0 0 0 0 0 0 0 0 0 24 0 0 0 22
22 0 0 0 0 0 0 0 0 0 0 0 0 0 0 22
22 0 0 0 0 0 0 0 0 0 24 0 0 0 0 22
22 0 0 0 0 0 0 0 0 0 0 0 0 0 0 22
22 0 0 0 0 0 0 0 24 0 0 0 0 0 0 22
22 0 0 0 0 0 0 0 0 0 0 0 0 0 0 22
22 0 0 0 0 24 0 0 0 0 0 0 0 0 0 22
22 0 0 0 0 0 0 0 0 0 0 0 23 25 0 22
22 0 0 24 0 0 0 0 0 0 0 0 0 0 0 22
22 0 0 0 0 0 0 0 0 0 0 0 0 0 0 22
21 21 21 21 21 21 21 21 21 21 21 21 22 22 22 22
